1111111111111111111111111111111111111111111111111111111111111111111
1000001000001000000000000000000000000000000000000000000000000000001
1000001110001000000000000000000000000000000000000000000000000000001
1000000010001000000000000000000000000000000000000000000000000000001
1111111010111000000000000000000000000000000000000000000000000000001
1000001000001000000000000000000000000000000000000000000000000000001
1000001111011000000000000000000000000000000000000000000000000000001
1000100000010000000000000000000000000000000000000000000000000000001
1111100111001000000000000000000000000000000000000000000000000000001
1000100001100100000000000000000000000000000000000000000000000000001
1000103001210010000000000000000000000000000000000000000000000000001
1000100012021001000000000000000000000000000000000000000000000000001
1033111012002100100000000000000000000000000000000000000000000000001
1000003001200210000000000000000000000000000000000000000000000000001
1001000001200000000000000000000000000000000000000000000000000000001
1111111111122221111111111111111111111111111111111111111111111111111