1111111111111111111111111111111111111
1010110101000000000100000000000000003
4000100000000000000104343400000400004
1020102221000000000100000010000000006
4000100001000000000114303400000300001
1010000101000000000000000200000000003
1111111111511111111111111111111111111
2000000000000000000000000000000000006
4444444444444444444444444344444444443