2222222224444
2002000024098
2000000024044
2002022224044
2002000000044
2222222224444